劄	札
啟	啓
凈	浄
痹	痺
阱	穽
雞	鷄
鐮	鎌
従	從
巢	巣
娛	娯
戶	戸
歲	歳
够	夠
唷	喲
鄉	郷
姊	姐
嚐	嘗
篡	簒
瘾	癮
黃	黄
每	毎
剎	刹
弒	弑
晚	晩
值	値
巔	巓
粛	肅
沉	沈
吞	呑
丟	丢
查	査
俱	倶
銳	鋭
說	説
脫	脱
閱	閲
步	歩
涉	渉
污	汚
汙	汚
朵	朶
垛	垜
剁	刴
偷	偸
喻	喩
絕	絶
豔	艷
歷	歴
曆	暦
產	産
彥	彦
內	内
呐	吶
掰掰	拜拜
‧	・
稅	税
牠	它
彆	別
溼	濕
徬	彷
鏟	剷
睏	困
鍊	煉
贗	贋